.......................................................................................................
..........C.......................................EC...........................................P.......
.........PPP..........PPP........................PPPPPP.........................C.............PP.......
..........................................................BB..................PPBPP..........PPP.......
................PPP.........................................................................PPPP.......
......................................PE.....P....E............E.P........PPPPPP...........PPPPP....G..
###############################....####################################################################
