........................................
........................................
.............B###........###............
.........B..............................
..................###...................
....................................G...
########################################