........................................................................................................
..........C......................................................EC.............................P.......
.........PPP..........PPP.........................C.............PPPPPP.........................PP.......
................................................PPBPP.........................................PPP.......
................PPP.....................................................BB...................PPPP.......
.........................................EP............PE......................E.P..........PPPPP....G..
###############################....#####################################################################
